6 10 1
@@@C@@@@@@
@@@......@
@@.....C@.
@...@@@@@@
@K..@.....
@@@@@.....
