5 5 2
@@@@@
K.@@@
@...@
....|
@@@@@
@K..@
...@@
@...@
@@@.@
@...C

